6 6 6 6 6 6 6 6 6 6 6 6 6 6 6 6 6 6 6 6 6 6 6 6 6 6 6
6 20 20 20 20 20 20 20 20 20 20 20 20 20 20 6 6 6 6 6 6 6 6 6 6 6 6
6 20 20 20 20 20 20 20 20 20 20 20 20 20 20 6 6 6 6 6 6 6 6 6 6 6 6 
6 20 20 20 9 12 12 12 12 12 12 12 11 20 20 6 6 6 6 6 6 6 6 6 6 6 6 
6 20 20 20 13 20 20 20 20 20 20 20 13 20 20 20 20 20 20 20 20 20 20 20 20 20 20
6 20 20 20 13 20 20 20 20 20 20 20 13 20 20 20 20 20 20 20 20 20 20 20 20 20 20
6 20 20 20 13 20 20 20 20 20 20 20 13 20 20 20 20 20 20 20 20 20 20 20 20 20 20
6 20 20 20 13 20 20 20 20 20 20 20 13 20 20 20 20 20 20 20 20 20 20 20 21 22 23
6 20 20 20 13 20 20 20 20 20 20 20 13 20 20 20 20 9 12 12 12 12 12 12 24 25 26
20 20 20 20 13 20 20 20 20 20 20 20 13 20 20 20 20 13 20 20 20 20 20 20 27 28 29
20 20 20 20 13 20 20 20 20 20 20 20 13 20 20 20 20 13 20 20 20 20 20 20 20 20 20
20 20 20 20 13 20 20 20 20 20 20 20 13 20 20 20 20 13 20 20 20 20 20 20 20 20 20
20 20 20 20 13 20 20 20 20 20 20 20 13 20 20 20 20 13 20 20 20 20 20 20 20 20 20
14 15 20 20 13 20 20 20 20 20 20 20 13 20 20 20 20 13 20 20 20 20 20 20 20 20 20
16 17 12 12 10 20 20 20 20 20 20 20 8 12 12 12 12 10 20 20 20 20 20 20 20 20 20
18 19 20 20 20 20 20 20 20 20 20 20 20 20 20 20 20 20 20 20 20 20 20 20 20 20 20
20 20 20 20 20 20 20 20 20 20 20 20 20 20 20 20 20 20 20 20 20 20 20 20 20 20 20
6 6 6 6 6 6 6 6 6 6 6 6 6 6 6 6 6 6 6 6 6 6 6 6 6 6 6 
