6 6 6 6 6 6 6 6 6 6 6 6 6 6 6 6 6 6 6 6 6 6 6 6 6 6 6
6 6 6 6 6 6 6 6 6 6 6 6 6 6 6 6 6 6 6 6 6 6 6 6 6 6 6
6 6 6 6 6 6 6 6 6 6 6 6 6 6 6 6 6 6 6 6 6 6 6 6 6 6 6
6 6 6 6 9 12 12 12 12 12 12 12 11 6 6 6 6 6 6 6 6 6 6 6 6 6 6
6 6 6 6 13 6 6 6 6 6 6 6 13 6 6 6 6 6 6 6 6 6 6 6 6 6 6
6 6 6 6 13 6 6 6 6 6 6 6 13 6 6 6 6 6 6 6 6 6 6 6 6 6 6
6 6 6 6 13 6 6 6 6 6 6 6 13 6 6 6 6 6 6 6 6 6 6 6 6 6 6
6 6 6 6 13 6 6 6 6 6 6 6 13 6 6 6 6 6 6 6 6 6 6 6 6 6 6
6 6 6 6 13 6 6 6 6 6 6 6 13 6 6 6 6 9 12 12 12 12 12 12 12 12 12
6 6 6 6 13 6 6 6 6 6 6 6 13 6 6 6 6 13 6 6 6 6 6 6 6 6 6
6 6 6 6 13 6 6 6 6 6 6 6 13 6 6 6 6 13 6 6 6 6 6 6 6 6 6
6 6 6 6 13 6 6 6 6 6 6 6 13 6 6 6 6 13 6 6 6 6 6 6 6 6 6
6 6 6 6 13 6 6 6 6 6 6 6 13 6 6 6 6 13 6 6 6 6 6 6 6 6 6
14 15 6 6 13 6 6 6 6 6 6 6 13 6 6 6 6 13 6 6 6 6 6 6 6 6 6
16 17 12 12 10 6 6 6 6 6 6 6 8 12 12 12 12 10 6 6 6 6 6 6 6 6 6
18 19 6 6 6 6 6 6 6 6 6 6 6 6 6 6 6 6 6 6 6 6 6 6 6 6 6
6 6 6 6 6 6 6 6 6 6 6 6 6 6 6 6 6 6 6 6 6 6 6 6 6 6 6
6 6 6 6 6 6 6 6 6 6 6 6 6 6 6 6 6 6 6 6 6 6 6 6 6 6 6
