6 6 6 20 9 12 12 12 12 12 12 12 12 11 20 6 6 6 6 6 6 6 6 6 6 6 6
6 6 6 20 13 20 20 20 20 20 20 20 20 13 20 6 6 6 6 6 6 6 6 6 6 6 6
14 15 6 20 8 12 11 20 6 6 6 6 20 13 20 6 6 6 6 6 6 6 6 6 6 6 6 
16 17 11 20 20 20 13 20 6 6 6 6 20 13 20 6 6 6 6 6 6 6 6 6 6 6 6 
18 19 13 20 6 20 13 20 6 6 6 6 20 13 20 6 6 6 6 6 6 20 6 6 6 6 6 6 
6 20 13 20 6 20 13 20 6 6 6 6 20 13 20 6 6 20 6 6 6 6 6 6 6 6 6
6 20 13 20 6 20 13 20 6 6 6 6 20 13 20 6 6 6 6 6 6 6 6 6 6 6 6
6 20 13 20 6 20 13 20 6 20 6 6 20 13 20 6 6 20 20 20 20 20 20 6 21 22 23
6 20 13 20 6 20 13 20 6 6 6 6 20 13 20 6 6 20 9 12 12 12 12 12 24 25 26
6 20 13 20 6 20 13 20 6 6 20 6 20 13 20 6 6 20 13 20 20 20 20 6 27 28 29
6 20 13 20 6 20 13 20 6 6 6 6 20 13 20 6 6 20 13 20 6 6 6 6 6 6 6
6 20 13 20 6 20 13 20 6 6 6 6 20 13 20 6 6 20 13 20 6 6 20 6 6 6 6
6 20 13 20 6 20 13 20 6 6 6 6 20 13 20 6 6 20 13 20 6 6 6 20 6 6 6
6 20 13 20 6 20 13 20 6 6 6 6 20 13 20 20 20 20 13 20 6 6 6 6 6 6 6
6 20 13 20 20 20 13 20 6 6 6 6 20 8 12 12 12 12 10 20 6 6 6 6 6 6 6
6 20 8 12 12 12 10 20 6 6 6 6 20 20 20 20 20 20 20 20 6 6 6 6 6 6 6
6 20 20 20 20 20 20 20 6 6 6 6 6 6 6 6 6 6 6 6 6 6 6 6 6 6 6
6 6 6 6 6 6 6 6 6 6 6 6 6 6 6 6 6 6 6 6 6 6 6 6 6 6 6 
